'''''''''''''''''''''''''''
'     C         C       C '
'                         '
' '            '    C     '
' ' '''' ' ''' ' '''' ''' '
' ' '  C  '        C' ' E '
' ' '                 '   '
' ' '       '             '
'                       ' '
' '    '               '  '
'''''''''           '''''''
' P           C           '
'''''''''''''''''''''''''''
