111111111111111111111111111
100000C000000000C0000000C01
100000000000000000000000001
10100000000000010000C000001
101000011101110101111011101
1010100C01000000000C1010E01
101011000000000000000010001
101010000000100000000000001
100000000000000000000000101
101000010000000000000001001
111111111000000000001111111
10P0000000000C0000000000001
111111111111111111111111111
