'''''''''''''
'  '        '
'      ''''''
'P C  E     '
'''''''''''''
