''''''''''
'  '     '
'   ''''''
'P C  E  '
''''''''''
