'''''''''''''
'  '       C'
'    '''''  '
'P  ''E     '
'''''''''''''