'''''''''''''
'  '        '
'    ''' ''''
'P C  E     '
'''''''''''''
