'''''''''''''
'  '        '
'    ''''''''
'P C  E     '
'''''''''''''
