1111111111
1001000001
1P00111111
100C00E001
1111111111
