'''''''''''''
'  '  C    C'
'    ''''''''
'P    E     '
'''''''''''''
